wwwwwwwwwwwww
wgw...A...wkw
w.w.......w.w
w.w.1...1.w.w
w0w.......w0w
w...........w
w..wwwwwww..w
w...........w
w.....mm....w
wwwwwwwwwwwww