wwwwwwwwwwwwwwwwwwwwwwwwww
w--......................w
w--..A.....xx....w..xx...w
w............oo..w..xx...w
w...w-w......xx........oow
w...wxw............--..oow
w...wxw..oowwwwww..--..oow
w........xxoo......w.....w
w-xx.......xx..xxx.w.....w
w-xx...............w.eoo.w
w-xx..ooooo...---.....oo.w
w.............---........w
wwwwwwwwwwwwwwwwwwwwwwwwww
