wwwwwwwwwwwwwwwwwwwwwwwwww
w--------xxxx------------w
w--xx-------------w-A----w
w--xx---.......---w------w
w-------.......---w----x-w
w-oo-------------------x-w
w-oo---x-----xxx-----xx--w
w------x-----xxx-----....w
w-----------w------x-....w
w---------oowoo------....w
w--e------oowoo----x-x...w
w---------------------...w
wwwwwwwwwwwwwwwwwwwwwwwwww
