wwwwwwwwwwwwwwwwwwwwwwwwww
w-ooo-------oo-----------w
w-xxx-------xx--------x--w
w--oo-------xx-----------w
w--xx----oo.....------..-w
w--------xx.....x-x---..-w
w---oo---xx.....x-x---..-w
w---oo--e-......x-x---..-w
w-o------...ooo...-------w
w-x-o----.........-------w
w---x----....A....----x--w
w--------.........-------w
wwwwwwwwwwwwwwwwwwwwwwwwww
