wwwwwwwwww
w........w
w...x....w
w.b---c..w
w...-....w
w.b---c..w
w...-...ow
wxxxAxxxxw
wexx.xxxxw
wwwwwwwwww
