wwwwwwwwwwwwwwwwwwwwwwwwww
w........................w
w.xx..................xx.w
w.xx...w....ww...w....xx.w
w.xx...w.........w....xx.w
w......w...e.A...w.......w
w......w.........w.......w
w......w.........w.......w
w..........ww............w
w.xxx...............xxx..w
w.xxx...............xx...w
w........................w
wwwwwwwwwwwwwwwwwwwwwwwwww
