wwwwwwwwwwwwwwwwwwwwwwwwww
w......--..............--w
w.xxx..--...e....xx....--w
w..x.............xxw.....w
w.....xxx..........w.....w
w.......x...------.wxx...w
w.--........-wwww-..xx...w
w.--...Aoo..---w--..x....w
w.......oo....-w-........w
w....x........-w-...oooo.w
w..xx..x.x.x..-w-...oooo.w
w.............-w-........w
wwwwwwwwwwwwwwwwwwwwwwwwww
