wwwwwwwwwwwwwwwwwwwwwwwwww
w-o--------o-------------w
w-x--------x-------xxoox-w
w-------------o------xx--w
w------ooooo--x----------w
w------ooooo--x---.....--w
w-x----xx-----x---...A.--w
w-x----xx-----x---.....--w
w--------ooo-....-----oo-w
w....----ooo-....xxx--oo-w
w.e..----ooo-....xxx--oo-w
w....----ooo-....--------w
wwwwwwwwwwwwwwwwwwwwwwwwww
