wwwwwwwwwwwwwwwwwwwwwwwwww
w........................w
w..A.xxxxx....e..x......xw
w.......................xw
w...................x...xw
w..xx......x.............w
w...............x........w
w........................w
w.x......................w
w.x.............x....x...w
w......xxxxx.............w
w........................w
wwwwwwwwwwwwwwwwwwwwwwwwww
