wwwwwwwwwwwwwwwwwwwwwwwwww
w..xx....xxxx..w.........w
w........wwww..w...e.....w
w..............w..ooo..x.w
w..ooo.........w.......x.w
w..ooo.................x.w
w........................w
w..............w.........w
w.......w......w.........w
w.......w...........x....w
w..w.xx.wxx.xx.w...Ax....w
w..w.xx.wxx.xx.w.........w
wwwwwwwwwwwwwwwwwwwwwwwwww
