wwwwwwwwwwwwwwwwwwwwwwwwww
w-ooo.......oo...........w
w-xxx.......xx...wwww.x..w
w..oo.www...xx...oooo....w
w..xx..w.oo..............w
w......w.xx.....x.x......w
w---oo.w.xx.....x.x......w
w---oo..e..w....x.x......w
w.o.......wwooo.....wwww.w
w.x.o.....ww.............w
w.........ww.A.......xx..w
w.........ww.............w
wwwwwwwwwwwwwwwwwwwwwwwwww
