wwwwwwwwwwwwwwwwwwwwwwwwww
w-----------xx----.....--w
w-----------xx----.....--w
w.....w..---------.....--w
w..xxxw..---------.....--w
w..xxxw..---------.....--w
w-----w-----A------------w
w-xx--w-------------xx---w
w-xx--w----------x--xxe--w
w-xx----........----xx---w
w-------........---------w
w-------........---------w
wwwwwwwwwwwwwwwwwwwwwwwwww
