wwwwwwwwwwwwwwwwwwwwwwwwww
w-o--------o------w------w
w-x---ww---x------wxxoox-w
w-----ww------o---w--xx-ww
w------ooooo--x----------w
w------ooooo--x---.....--w
w-x----xx-----x---...A.--w
w-x----xx-w---x---.....--w
www..wwwwowo----.wwwwwoo-w
w....----owo-....xxx--oo-w
w.e..----owo-....xxx--oo-w
w....----owo-....--------w
wwwwwwwwwwwwwwwwwwwwwwwwww
