wwwwwwwwwwwwwwwwwwwwwwwwww
w......................xxw
w.xxxx...................w
w..xx....................w
w..............xx........w
w..............xx........w
w....xx..................w
w...........A............w
w....................xx..w
w....................xx..w
w..e.....................w
w........xxxxx...........w
wwwwwwwwwwwwwwwwwwwwwwwwww
