wwwwwwwwwwwwwwwwwwwwwwwwww
w-----ooo--------oo---w--w
w--xxx---..xx----ooxx-wx-w
w--xxx---..x-----oo--ewx-w
w------ww..---o--ww---w--w
wwwww-----w--A---ww------w
wwwww-----w------ww------w
w---------...----ww--xx--w
w--wwww-.....----ww--xx--w
w---xx--.....-oo-ww--xx--w
w---xx--.....----oo------w
w-------.....----oo------w
wwwwwwwwwwwwwwwwwwwwwwwwww
