wwwwwwwwwwwwwwwwwwwwwwwwww
w..xx....xxxxw...........w
w........wwww......e.....w
w.................ooo..x.w
w..ooo....--...........x.w
w..ooo....--...........x.w
w..............w.........w
w..............w.........w
w.......w......w.........w
w.......w......w.........w
w..w.xx.wxxxxx.w...A.....w
w..w.xx.wxxxxx.w.........w
wwwwwwwwwwwwwwwwwwwwwwwwww
