wwwwwwwwwwwwwwwwwwwwwwwwww
w.......w................w
w.A..e..w...x.x..........w
w.......w..........xxx...w
w.......woooo.........wwww
w.xx....w.......w..ooo...w
w.....x.w..---x.w..ooo...w
w.......w..---..w........w
w....x..........w..ooooo.w
w........x..x...w..xxxxx.w
w.oooo...x......w..xxxxx.w
w...............w........w
wwwwwwwwwwwwwwwwwwwwwwwwww
