wwwwwwwwwwwwwwwwwwwwwwwwww
w........................w
w.A..e......x.x..........w
w..................xxx...w
w........oooo............w
w.xx...............ooo...w
w.....x....---x....ooo...w
w..........---...........w
w....x.............ooooo.w
w........x..x......xxxxx.w
w.oooo...x.........xxxxx.w
w........................w
wwwwwwwwwwwwwwwwwwwwwwwwww
