wwwwwwwwwwwwwwwwwwwwwwwwww
w.xx.xx................xxw
w........ww..oo....e...xxw
w........ww..oo........xxw
w.xx.....ww..............w
w........ww..............w
w.........---..wwwwxwwww.w
w.........---............w
w...www................o.w
w..........xx..........o.w
w.xx.x.....xx......A...o.w
w.xx.x...................w
wwwwwwwwwwwwwwwwwwwwwwwwww
