wwwwwwwwwwwwwwwwwwwwwwwwww
w.......oxx-xx..xxx...ooxw
w.......oxx-xx..xxx...ooxw
w..wwwwwwwwwwwwoowwwwww.xw
w.xx....................xw
w.....oo.................w
w.....oo..xx.....w..ooo..w
w.....oo.ww----..w..ooo..w
w.....oo.ww----..w.......w
w.www.........x..w.......w
w..A.............w....e..w
w........................w
wwwwwwwwwwwwwwwwwwwwwwwwww
